   A   #                  A             
       ##                   #           
  #     #                   #           
  #     #      #######      #       #   
  #     #      #            #       #   
  #            #            #       #   
  #     #      #            #       #   
  #     #      ######################   
  #     #      #                        
  ##############                       A
    #          #    ^    #########      
    #          #                 #      
    #          #                 #      
    #          #                 #      
    #          ##############    #      
    #                            #      
    #    #                       #      
    #    #                       #      
    #    #########################      
    # A                                 
